40000006
38888882
38888882
38888882
38888882
51111117